5 10
|--------|
|..|..-..|
|..-..|..|
|.@..|...|
|--------|